11111111
10000 11
10 01011
100  001
10000001
10000001
1001 0N1
11111111
