R 640 480
NO ../src/textures/wood.xpm
SO ../src/textures/redbrick.xpm
WE ../src/textures/mossy.xpm
EA ../src/textures/colorstone.xpm
S ../src/textures/barrel.xpm
C 204,255,255
F 153,76,0

11111111111111111111111111111111
10000000000000001000000000000001
10000000000000002000000000000001
11000000000000000000000000000011
1100000002000000N000200000000011
11000000000000000000000000000011
10000000000000002000000000000011
10000000000000000000000000000001
10000000000000011000000000000001
11111111111111111111111111111111
